1111111111111111111111111111
1C00EC0000C100010C1C00100C01
1000000000010C010E10E010E001
1111000001110000000000100001
1C0000010000E0000E0000111001
1P00001100000C00000000000001
110E0010C0000000000000000001
11100E000000000001C000000001
1CQ0000100000000E00001110011
1111111111111111111111111111
